10 10 18 18 18 18 18 18 10 10 18 18 18 10 10 18 18 10 10 18 10 10 10 10 10 10 18 19 0 0 0 0 0 0 0 0 0 0 0 0 0 0 0 0 0 0 0 0 0 0 0 0 0 0 0 0 0 0 0 0 0 0 0 0 0 0 0 0 0 0 0 0 0 0 0 0 0 0 0 0 
10 19 0 0 0 0 0 0 9 11 0 0 0 17 19 0 14 9 11 0 17 18 18 18 18 19 0 0 0 0 0 0 0 0 0 0 0 0 0 0 0 0 0 0 0 0 0 0 0 0 0 0 0 0 0 0 0 0 0 0 0 0 0 0 0 0 0 0 0 0 0 0 0 0 0 0 0 0 0 0 
11 0 0 0 0 0 0 0 9 11 0 0 0 0 0 0 14 9 11 0 0 0 0 0 0 0 0 0 0 0 0 0 0 0 4 0 0 0 0 0 0 0 0 0 0 0 0 0 0 0 0 0 0 0 0 0 0 0 0 0 0 0 0 0 0 0 0 0 0 0 0 0 0 0 0 0 0 0 0 0 
11 0 0 0 0 0 0 0 17 11 0 0 0 0 0 0 14 9 11 0 0 0 0 0 0 0 0 0 0 0 0 0 0 0 5 0 0 0 0 0 0 0 0 0 0 0 0 0 0 0 0 0 0 5 0 0 0 4 0 0 0 0 0 0 0 0 0 0 0 0 0 0 0 0 0 0 0 0 0 0 
11 0 0 0 0 4 0 0 0 13 0 0 0 4 0 0 14 9 11 0 0 0 0 0 0 0 0 0 0 0 0 0 0 0 13 0 0 0 0 0 0 0 0 0 0 0 0 0 0 0 4 0 0 13 0 0 1 2 3 0 0 0 0 0 0 4 0 0 0 0 0 4 0 0 0 0 0 0 0 0 
11 24 24 0 0 5 0 0 0 13 24 0 0 5 0 0 14 9 19 0 0 0 0 0 0 0 0 0 1 2 2 3 0 0 21 0 0 0 0 0 0 0 0 0 0 0 0 0 0 0 5 0 0 21 0 0 9 10 11 0 0 0 0 0 1 2 3 0 0 14 1 2 2 3 0 0 14 1 2 3 
11 0 0 0 0 13 0 0 0 21 0 0 0 13 0 0 14 21 0 0 0 0 0 0 0 0 0 0 17 18 18 19 0 0 0 0 0 0 0 0 0 0 0 0 0 0 0 0 0 0 13 0 0 0 0 0 17 18 19 0 0 0 0 0 9 10 11 0 0 14 17 18 18 19 0 0 14 9 10 11 
11 0 0 0 0 13 0 0 0 0 0 0 0 13 0 0 0 0 0 0 0 0 1 2 2 3 0 0 0 0 0 0 0 0 0 0 0 0 0 0 0 0 0 0 0 0 4 0 0 0 21 0 0 0 0 0 0 0 0 0 0 0 0 0 17 18 19 0 0 0 0 0 0 0 0 0 14 9 10 11 
11 0 0 0 0 21 0 0 0 0 0 0 0 21 0 0 0 0 0 0 0 0 9 10 10 19 0 0 0 0 0 0 0 0 0 4 0 0 0 4 0 0 0 0 0 0 5 0 0 0 0 0 0 4 4 4 0 0 0 0 0 0 0 0 0 0 0 0 0 0 0 0 0 0 0 0 14 9 10 11 
11 0 0 0 0 0 0 0 0 0 0 0 0 0 0 0 0 1 2 3 0 0 9 10 11 0 0 0 0 0 0 0 0 0 0 1 2 2 2 3 0 0 0 0 0 0 13 0 0 0 0 0 0 1 2 3 0 0 0 1 2 3 0 0 0 0 0 0 0 0 0 0 0 0 0 0 14 9 10 11 
10 2 3 0 0 0 0 0 0 0 0 0 0 0 0 0 0 17 18 19 0 0 9 10 11 0 0 0 0 0 0 0 0 0 0 17 18 18 18 19 0 0 0 0 0 0 21 0 0 0 0 0 0 17 18 19 0 0 0 9 10 11 0 0 0 0 0 0 0 0 0 0 0 0 0 0 14 9 10 11 
10 10 11 22 22 22 22 22 22 22 22 22 22 22 22 22 22 22 22 22 22 22 9 10 11 22 22 22 22 22 22 22 22 22 22 22 22 22 22 22 22 1 2 3 22 22 22 22 22 22 22 22 22 22 22 22 22 22 22 17 18 19 22 22 22 22 22 22 22 22 22 22 22 22 22 22 22 9 10 11
