9	9	17	17	17	17	17	17	9	9	17	17	17	9	9	17	17	9	9	17	9	9	9	9	9	9	17	18	-1	-1	-1	-1	-1	-1	-1	-1	-1	-1	-1	-1	-1	-1	-1	-1	-1	-1	-1	-1	-1	-1	-1	-1	-1	-1	-1	-1	-1	-1	-1	-1	-1	-1	-1	-1	-1	-1	-1	-1	-1	-1	-1	-1	-1	-1	-1	-1	-1	-1	-1	-1
9	18	-1	-1	-1	-1	-1	-1	8	10	-1	-1	-1	16	18	-1	13	8	10	-1	16	17	17	17	17	18	-1	-1	-1	-1	-1	-1	-1	-1	-1	-1	-1	-1	-1	-1	-1	-1	-1	-1	-1	-1	-1	-1	-1	-1	-1	-1	-1	-1	-1	-1	-1	-1	-1	-1	-1	-1	-1	-1	-1	-1	-1	-1	-1	-1	-1	-1	-1	-1	-1	-1	-1	-1	-1	-1
10	-1	-1	-1	-1	-1	-1	-1	8	10	-1	-1	-1	-1	-1	-1	13	8	10	-1	-1	-1	-1	-1	-1	-1	-1	-1	-1	-1	-1	-1	-1	-1	3	-1	-1	-1	-1	-1	-1	-1	-1	-1	-1	-1	-1	-1	-1	-1 	-1	-1	-1	-1	-1	-1	-1	-1	-1	-1	-1	-1	-1	-1	-1	-1	-1	-1	-1	-1	-1	-1	-1	-1	-1	-1	-1	-1	-1	-1
10	-1	-1	-1	-1	-1	-1	-1	16	10	-1	-1	-1	-1	-1	-1	13	8	10	-1	-1	-1	-1	-1	-1	-1	-1	-1	-1	-1	-1	-1	-1	-1	4	-1	-1	-1	-1	-1	-1	-1	-1	-1	-1	-1	-1	-1	-1	-1	-1	-1	-1	4	-1	-1	-1	3	-1	-1	-1	-1	-1	-1	-1	-1	-1	-1	-1	-1	-1	-1	-1	-1	-1	-1	-1	-1	-1	-1
10	-1	-1	-1	-1	3	-1	-1	-1	12	-1	-1	-1	3	-1	-1	13	8	10	-1	-1	-1	-1	-1	-1	-1	-1	-1	-1	-1	-1	-1	-1	-1	12	-1	-1	-1	-1	-1	-1	-1	-1	-1	-1	-1	-1	-1	-1	-1	3	-1	-1	12	-1	-1	0	1	2	-1	-1	-1	-1	-1	-1	3	-1	-1	-1	-1	-1	3	-1	-1	-1	-1	-1	-1	-1	-1
10	23	23	-1	-1	4	-1	-1	-1	12	23	-1	-1	4	-1	-1	13	8	18	-1	-1	-1	-1	-1	-1	-1	-1	-1	0	1	1	2	-1	-1	20	-1	-1	-1	-1	-1	-1	-1	-1	-1	-1	-1	-1	-1	-1	-1	4	-1	-1	20	-1	-1	8	9	10	-1	-1	-1	-1	-1	0	1	2	-1	-1	13	0	1	1	2	-1	-1	13	0	1	2
10	-1	-1	-1	-1	12	-1	-1	-1	20	-1	-1	-1	12	-1	-1	13	20	-1	-1	-1	-1	-1	-1	-1	-1	-1	-1	16	17	17	18	-1	-1	-1	-1	-1	-1	-1	-1	-1	-1	-1	-1	-1	-1	-1	-1	-1	-1	12	-1	-1	-1	-1	-1	16	17	18	-1	-1	-1	-1	-1	8	9	10	-1	-1	13	16	17	17	18	-1	-1	13	8	9	10
10	-1	-1	-1	-1	12	-1	-1	-1	-1	-1	-1	-1	12	-1	-1	-1	-1	-1	-1	-1	-1	0	1	1	2	-1	-1	-1	-1	-1	-1	-1	-1	-1	-1	-1	-1	-1	-1	-1	-1	-1	-1	-1	-1	3	-1	-1	-1	20	-1	-1	-1	-1	-1	-1	-1	-1	-1	-1	-1	-1	-1	16	17	18	-1	-1	-1	-1	-1	-1	-1	-1	-1	13	8	9	10
10	-1	-1	-1	-1	20	-1	-1	-1	-1	-1	-1	-1	20	-1	-1	-1	-1	-1	-1	-1	-1	8	9	9	18	-1	-1	-1	-1	-1	-1	-1	-1	-1	3	-1	-1	-1	3	-1	-1	-1	-1	-1	-1	4	-1	-1	-1	-1	-1	-1	3	3	3	-1	-1	-1	-1	-1	-1	-1	-1	-1	-1	-1	-1	-1	-1	-1	-1	-1	-1	-1	-1	13	8	9	10
10	-1	-1	-1	-1	-1	-1	-1	-1	-1	-1	-1	-1	-1	-1	-1	-1	0	1	2	-1	-1	8	9	10	-1	-1	-1	-1	-1	-1	-1	-1	-1	-1	0	1	1	1	2	-1	-1	-1	-1	-1	-1	12	-1	-1	-1	-1	-1	-1	0	1	2	-1	-1	-1	0	1	2	-1	-1	-1	-1	-1	-1	-1	-1	-1	-1	-1	-1	-1	-1	13	8	9	10
9	1	2	-1	-1	-1	-1	-1	-1	-1	-1	-1	-1	-1	-1	-1	-1	16	17	18	-1	-1	8	9	10	-1	-1	-1	-1	-1	-1	-1	-1	-1	-1	16	17	17	17	18	-1	-1	-1	-1	-1	-1	20	-1	-1	-1	-1	-1	-1	16	17	18	-1	-1	-1	8	9	10	-1	-1	-1	-1	-1	-1	-1	-1	-1	-1	-1	-1	-1	-1	13	8	9	10
9	9	10	21	21	21	21	21	21	21	21	21	21	21	21	21	21	21	21	21	21	21	8	9	10	21	21	21	21	21	21	21	21	21	21	21	21	21	21	21	21	0	1	2	21	21	21	21	21	21	21	21	21	21	21	21	21	21	21	16	17	18	21	21	21	21	21	21	21	21	21	21	21	21	21	21	21	8	9	10