2 0 0 0 0 0 0 0 0 0 0 0 0 0 0 0 0 0 0 4 
2 0 0 0 6 1 7 0 0 0 0 0 0 0 0 0 0 0 0 4 
2 0 0 0 5 9 9 7 0 0 26 0 0 21 0 0 0 0 0 4 
9 7 0 0 0 4 9 9 1 7 0 0 0 0 0 0 0 0 0 4 
9 8 0 0 0 4 9 9 9 9 1 1 1 1 1 1 1 1 1 9 
2 0 0 0 0 4 9 9 9 9 9 9 9 9 9 9 9 9 9 9 
2 0 0 0 6 9 9 9 3 3 3 3 9 9 3 23 23 23 3 9
2 0 0 0 4 9 9 8 0 0 0 0 5 8 0 0 0 0 0 4 
9 7 0 0 4 9 8 0 0 0 0 0 0 0 0 0 0 0 0 4 
9 8 0 0 5 8 0 0 20 0 0 20 0 0 0 0 0 25 0 4 
2 0 0 24 0 0 0 0 0 0 0 0 0 6 1 22 22 1 1 9 
9 1 1 1 1 1 1 1 1 1 1 1 1 9 9 9 9 9 9 9 