0  0  0  -4  -9  4  2  -9  -2  0  0  0  0  0  0  -4  -9  -9  -9  -2  
0  0  0  -5  -3  4  2  -3  -8  0  0  0  0  0  0  -4  -9  -9  -9  -2  
0  0  0  20  0  5  8  0  0  6  1  7  0  0  0  14  18  18  15  -2  
-1  -7  0  0  0  0  0  0  0  4  16  0  0  0  0  0  -5  -3  -3  -8  
-9  -2  0  11  0  0  0  0  0  12  0  0  0  6  7  0  0  0  0  0  
15  -2  0  12  0  0  21  0  0  12  0  0  6  9  9  1  1  1  7  0  
-9  -2  0  12  0  0  0  0  0  12  0  17  3  3  3  3  9  9  9  1  
-9  -2  0  12  0  0  0  0  0  12  0  0  0  20  0  0  5  3  9  9  
-9  -2  0  12  0  0  11  0  0  12  0  0  0  0  0  0  25  0  5  9  
-9  -2  0  12  0  0  0  0  0  4  7  0  0  0  0  0  0  0  0  4  
1  1  1  2  0  0  0  0  0  4  9  1  1  1  1  1  1  1  1  9  
9  9  9  2  0  0  0  0  0  4  9  9  9  9  9  9  9  9  9  9  